      ┌───┐     ┌─┐   
q0_0: ┤ H ├──■──┤M├───
      └───┘┌─┴─┐└╥┘┌─┐
q0_1: ─────┤ X ├─╫─┤M├
           └───┘ ║ └╥┘
c0: 2/═══════════╩══╩═
                 0  1 